000000000000000000000
022222222230022222000
020002000222220202200
020222222200200200220
022200000222222200020
020222022202000222220
020202220272022202020
020200200202020002020
022222222222222222220
008020000000000020800
000052222282222220000
008020000000000020800
022222222222222222220
020200020202002002020
020202220272022202020
022222000202220222020
020002222222000002220
022002002002222222020
002202022222000200020
000222220092222222220
000000000000000000000